55 55 55 55 55 55 55 55 55 55 55 55 55 55 55 55 55 55 55 55 55 55 55 55 55 55 55 55 55 55 55 55 55 55 55 55 55 55 55 55 55 55 55 55 55 55 55 55 55 55 
55 55 55 55 55 55 55 55 55 55 55 55 55 55 55 55 55 55 55 55 55 55 55 55 55 55 55 55 55 55 55 55 55 55 55 55 55 55 55 55 55 55 55 55 55 55 55 55 55 55 
55 55 55 55 55 55 55 55 55 55 55 55 55 55 55 55 55 55 55 55 55 55 55 55 55 55 55 55 55 55 55 55 55 55 55 55 55 55 55 55 55 55 55 55 55 55 55 55 55 55 
55 55 55 7 9 9 9 9 9 9 9 9 9 9 9 9 9 9 9 9 9 9 9 9 9 9 9 9 9 9 9 9 9 9 9 9 9 9 9 9 9 9 9 9 9 9 62 55 55 55 
55 55 55 8 22 30 30 21 21 21 21 21 29 43 43 43 10 34 43 34 6 34 5 16 63 63 63 63 63 63 4 22 30 29 6 10 22 29 71 34 19 38 19 19 71 38 61 55 55 55 
55 55 55 8 26 25 25 27 27 27 25 25 28 43 54 54 54 54 43 34 10 43 34 16 32 32 32 32 32 32 17 1 12 23 2 2 1 23 71 15 32 32 31 32 13 38 61 55 55 55 
55 55 55 8 26 25 27 25 25 25 25 25 28 54 32 32 32 36 54 43 34 15 63 36 32 36 31 32 32 31 32 18 71 34 15 63 63 63 63 32 36 32 36 32 32 33 61 55 55 55 
55 55 55 8 26 27 27 25 27 27 27 27 28 54 32 31 31 32 54 10 4 15 24 32 32 32 36 32 32 36 32 13 10 71 15 32 36 32 32 35 31 32 32 32 17 2 61 55 55 55 
55 55 55 8 26 27 27 27 27 27 27 27 28 54 32 31 32 32 54 43 43 15 32 32 32 32 32 32 32 32 32 18 22 29 15 32 32 31 32 32 32 32 36 32 18 19 61 55 55 55 
55 55 55 8 26 27 27 27 27 27 27 27 28 54 32 36 32 32 54 10 43 15 32 31 36 32 31 32 36 32 24 43 1 23 15 32 32 32 32 32 32 36 32 32 32 13 61 55 55 55 
55 55 55 8 26 27 27 27 27 27 27 27 28 54 32 32 32 32 54 43 10 5 16 32 32 32 32 32 32 32 17 22 29 34 15 36 32 32 32 36 32 32 32 36 32 13 61 55 55 55 
55 55 55 8 26 25 27 27 27 27 27 27 28 54 36 32 31 32 54 10 6 22 29 10 36 32 36 32 32 17 10 1 23 43 15 31 32 32 32 32 32 32 36 32 32 13 61 55 55 55 
55 55 55 8 26 27 27 27 27 25 25 27 28 54 36 36 31 31 54 43 43 1 23 38 15 32 32 32 17 43 10 71 10 10 15 32 32 36 36 32 32 32 32 32 13 43 61 55 55 55 
55 55 55 8 1 0 0 0 0 0 0 12 23 54 14 14 14 14 54 5 71 10 22 29 16 36 31 13 10 22 29 10 71 10 43 16 32 32 32 36 36 32 32 13 22 29 61 55 55 55 
55 55 55 8 4 10 43 6 10 22 29 10 43 34 54 63 63 54 34 10 71 43 1 23 10 14 32 18 6 1 23 4 10 34 43 15 32 36 32 32 32 32 31 18 1 23 61 55 55 55 
55 55 55 8 22 29 43 22 29 1 23 43 43 43 15 36 31 18 72 69 69 69 69 69 41 15 36 18 43 10 10 22 30 30 29 15 32 32 32 31 32 31 32 63 63 43 61 55 55 55 
55 55 55 8 1 23 10 1 23 43 22 29 43 43 15 32 31 18 11 70 49 48 48 48 41 15 31 18 22 29 10 26 27 27 28 15 32 31 32 32 36 32 36 32 32 13 61 55 55 55 
55 55 55 8 4 66 10 43 4 10 1 23 43 43 15 32 36 18 71 70 48 48 48 48 41 15 32 18 1 23 10 1 0 12 23 15 32 32 32 32 32 32 32 32 31 17 61 55 55 55 
55 55 55 8 43 66 22 29 6 43 10 43 43 19 16 36 32 18 66 70 48 48 48 42 41 15 32 18 10 22 29 43 63 63 63 63 14 14 38 14 14 16 32 31 18 43 61 55 55 55 
55 55 55 8 22 29 1 23 10 43 6 2 15 32 32 32 32 18 6 70 48 48 48 48 41 15 32 18 71 1 23 15 36 32 32 31 13 2 6 10 34 15 36 32 18 43 61 55 55 55 
55 55 55 8 1 23 6 10 43 10 43 43 15 32 31 17 14 68 68 70 42 42 48 48 41 15 36 18 43 10 71 15 32 35 32 32 13 34 34 34 34 15 32 31 18 10 61 55 55 55 
55 55 55 8 10 68 68 68 68 68 68 10 15 32 32 18 67 42 48 42 22 29 42 42 41 15 32 18 6 22 29 15 32 36 32 36 13 19 19 19 2 15 32 32 18 38 61 55 55 55 
55 55 55 8 67 42 48 48 48 49 48 51 15 32 32 18 67 48 48 42 1 23 34 42 41 15 31 13 10 1 23 15 32 31 32 32 32 32 31 32 10 15 32 32 18 34 61 55 55 55 
55 55 55 8 67 48 48 48 48 48 48 51 15 31 32 18 67 48 49 48 42 42 42 53 44 15 32 18 43 10 72 43 14 14 14 14 14 15 32 32 33 16 36 32 18 34 61 55 55 55 
55 55 55 8 67 48 48 19 19 19 48 51 15 32 32 18 67 48 48 48 48 48 48 51 10 15 32 18 71 22 22 29 22 29 22 29 71 15 32 36 32 32 32 31 18 34 61 55 55 55 
55 55 55 8 67 48 15 32 36 13 48 51 15 32 32 18 39 40 40 40 40 40 40 50 10 15 36 18 4 71 1 23 1 23 1 23 43 15 32 31 32 36 32 32 18 34 61 55 55 55 
55 55 55 8 67 48 15 32 32 13 48 51 15 32 32 18 19 19 19 19 19 19 19 19 19 16 32 63 63 63 63 63 63 63 63 63 63 63 32 32 33 34 34 34 34 34 61 55 55 55 
55 55 55 8 67 48 15 32 32 13 48 51 15 31 32 32 32 32 32 31 32 32 32 32 32 31 32 32 32 32 32 31 32 36 32 32 32 36 32 31 18 22 30 30 29 10 61 55 55 55 
55 55 55 8 67 15 31 31 36 13 48 51 15 32 32 32 31 32 32 32 32 32 33 14 14 14 31 14 15 32 32 32 32 32 32 31 32 32 32 32 18 1 12 12 23 10 61 55 55 55 
55 55 55 8 67 48 14 14 14 48 42 51 43 14 14 14 14 14 14 14 14 14 43 34 10 63 32 13 10 14 14 14 14 14 14 14 14 14 14 14 38 11 10 10 10 34 61 55 55 55 
55 55 55 8 67 48 48 48 49 48 48 50 22 29 5 43 22 29 34 10 4 72 10 34 15 31 32 13 22 30 29 66 22 29 22 29 22 30 30 29 34 10 71 38 10 10 61 55 55 55 
55 55 55 8 39 40 40 40 40 64 64 64 1 23 10 10 1 23 10 5 66 10 22 29 15 32 32 13 1 12 23 38 26 28 1 23 26 27 25 28 10 34 10 71 34 10 61 55 55 55 
55 55 55 8 10 10 10 43 43 10 43 43 10 43 43 66 10 10 22 29 10 66 1 23 15 32 32 13 43 10 43 10 1 23 72 66 1 12 12 23 38 19 72 10 34 10 61 55 55 55 
55 55 55 8 22 29 10 10 43 43 43 10 10 10 43 43 54 54 1 23 22 29 10 5 15 32 32 13 43 10 10 71 10 34 72 5 19 19 19 16 32 32 17 38 72 38 61 55 55 55 
55 55 55 8 1 23 43 10 54 54 54 54 54 54 54 54 54 54 10 4 1 23 22 29 15 32 32 13 10 10 34 5 71 38 71 16 32 32 32 32 31 32 32 17 22 29 61 55 55 55 
55 55 55 8 10 10 43 10 54 32 35 32 36 32 32 31 36 54 10 10 10 10 1 23 15 32 31 13 38 43 19 19 72 19 16 32 36 32 36 31 32 36 32 37 1 23 61 55 55 55 
55 55 55 8 10 10 43 43 54 32 32 36 32 32 32 32 36 54 10 38 10 10 22 29 15 32 32 32 36 32 32 36 32 32 36 31 32 32 32 32 32 32 32 37 38 71 61 55 55 55 
55 55 55 8 22 29 33 43 54 36 32 32 32 31 32 32 32 54 10 10 2 10 1 23 15 32 36 13 14 14 14 14 14 16 32 32 32 31 36 32 32 36 32 37 22 29 61 55 55 55 
55 55 55 8 1 23 10 43 54 32 32 36 32 32 36 32 31 54 42 10 22 30 29 10 15 32 32 13 72 22 29 22 29 15 32 32 32 32 32 36 32 35 32 37 1 23 61 55 55 55 
55 55 55 8 10 10 43 43 54 54 32 32 32 32 32 32 32 32 18 42 1 12 23 10 16 32 32 63 63 1 23 1 23 15 32 32 36 32 32 32 31 32 32 37 11 71 61 55 55 55 
55 55 55 8 10 10 10 43 34 54 54 54 54 54 54 31 32 31 36 19 19 19 19 36 32 32 36 36 32 13 22 29 10 71 14 15 32 31 32 32 32 32 36 37 22 29 61 55 55 55 
55 55 55 8 22 30 29 22 29 34 34 34 34 34 54 54 54 17 32 31 32 32 32 32 32 36 31 32 31 13 1 23 10 22 29 34 14 14 14 14 14 14 14 38 1 23 61 55 55 55 
55 55 55 8 26 27 29 26 28 34 34 34 34 34 10 4 10 42 14 14 14 71 14 16 32 32 32 32 32 13 34 71 72 1 23 71 10 22 29 10 22 29 34 71 10 10 61 55 55 55 
55 55 55 8 1 12 23 1 23 34 34 34 34 34 10 22 29 10 34 34 22 29 34 34 16 14 14 14 14 14 34 71 10 10 10 10 71 1 23 71 1 23 10 71 22 29 61 55 55 55 
55 55 55 8 10 10 10 10 10 22 29 10 11 22 29 1 23 10 71 10 1 23 22 29 10 34 34 22 29 34 10 10 71 22 29 22 29 10 71 10 22 21 29 10 1 23 61 55 55 55 
55 55 55 8 10 10 10 10 10 1 23 10 10 1 23 10 10 10 10 10 10 10 1 23 10 10 10 1 23 10 10 10 10 1 23 1 23 10 10 10 1 12 23 10 10 10 61 55 55 55 
55 55 55 58 57 57 57 57 57 57 57 57 57 57 57 57 57 57 57 57 57 57 57 57 57 57 57 57 57 57 57 57 57 57 57 57 57 57 57 57 57 57 57 57 57 57 59 55 55 55 
55 55 55 55 55 55 55 55 55 55 55 55 55 55 55 55 55 55 55 55 55 55 55 55 55 55 55 55 55 55 55 55 55 55 55 55 55 55 55 55 55 55 55 55 55 55 55 55 55 55 
55 55 55 55 55 55 55 55 55 55 55 55 55 55 55 55 55 55 55 55 55 55 55 55 55 55 55 55 55 55 55 55 55 55 55 55 55 55 55 55 55 55 55 55 55 55 55 55 55 55 
55 55 55 55 55 55 55 55 55 55 55 55 55 55 55 55 55 55 55 55 55 55 55 55 55 55 55 55 55 55 55 55 55 55 55 55 55 55 55 55 55 55 55 55 55 55 55 55 55 55 